FPGA : Field Programable Gate Array
drv : driver
cd : clock domain
cdc : clock domain crossing
SPI : Serial Peripheral Interface
I2C : Inter Intergrated Circuit
UART : Universal Asynchronous Receiver/Transmitter
LUT : Look Up Table
PLB : Programable Logic Block
HDL : Hardware Description Language
BRAM : Block RAM
SPRAM : Single Port RAM
SRAM : Static RAM
oe : output enable
vcd : value change dump
pwm : pulse width modulation
dsp : digital signal processing
adc : a/d : analog digital converter
pnr : place and route
csr : control/status register
crc : cyclic redundancy check
mm : memory mapped
lsb : least significant bit
msb : most significant bit
XADC : Xilinx Ultrascale System Monitor
CRG : Clock Resource Generator
PLL : Phase Lock Loop
CDC : ACM : Communication Device Class / Abstract Control Model / USB context

por : Power on Reset
IRQ : Interrupt ReQuest
